6 12 4
++++X+++++++
++S  +  ++S+
+  + ++ +  M
+ +++   + ++
+  +  +  SS+
++   +++++++